....................
........G...........
....................
.....######.........
....................
....................
..........######....
....................
....................
.....######.........
....................
........+...........
..........######....
....................
....................
.....######.........
....................
.H..................
..........######....
....................
....................
.....######.........
....................
....................
..........######....
....................
....................
.....######.........
....................
....................
..........######....
....................
....................
....###########.....
....................
